0 0 0 0 0 0 0 0 0 0 0 0 0 0 0 0 0 0 0 0 0 0 0 0 0 0 0 0 0 0 0 0
0 0 0 0 8 8 8 8 8 8 8 8 8 8 8 8 8 8 8 8 8 8 8 8 8 8 8 6 8 8 8 0
0 0 0 0 8 8 8 8 8 8 8 8 8 8 8 8 8 8 8 8 8 8 8 8 8 8 8 6 2 7 8 0
0 0 0 0 8 8 8 8 8 8 8 8 8 8 8 8 8 8 8 8 8 8 8 8 8 8 8 6 2 7 8 0
0 0 0 0 8 8 8 8 8 8 8 8 8 8 8 8 8 8 8 8 8 8 8 8 8 8 8 6 2 7 8 0
0 0 0 0 8 8 8 8 8 8 8 8 8 8 8 8 8 8 8 8 8 8 8 8 8 8 8 6 2 7 8 0
0 0 0 0 8 8 8 8 8 8 8 8 8 8 8 8 8 8 8 8 8 2 2 4 9 2 2 6 2 7 7 0
0 0 0 0 8 8 8 8 8 8 8 8 8 8 8 8 8 8 8 8 8 3 2 2 2 2 2 6 2 7 7 0
0 0 0 0 8 8 8 8 8 8 8 8 8 8 8 8 8 8 8 8 8 2 2 5 7 2 2 6 2 7 7 0
0 0 0 0 8 8 8 8 8 8 8 8 8 8 8 8 8 8 8 8 8 8 8 8 8 8 8 6 2 7 2 0
0 0 0 0 8 8 8 8 8 8 8 8 8 8 8 8 8 8 8 8 8 8 8 8 8 8 8 6 2 7 8 0
0 0 0 0 8 8 8 8 8 8 8 8 8 8 8 8 8 8 8 8 8 8 8 8 8 8 8 6 2 7 8 0
0 0 0 0 8 8 8 8 8 8 8 8 8 8 8 8 8 2 3 2 2 2 8 8 8 8 8 6 2 7 8 0
0 0 0 0 8 8 8 8 8 8 6 2 7 2 2 2 3 2 0 0 2 2 4 2 2 2 2 8 2 7 8 0
0 0 0 0 8 8 8 8 8 8 6 2 7 8 2 3 2 4 0 0 2 3 2 3 2 2 2 8 2 7 8 0
0 0 0 0 8 8 8 8 8 8 6 2 7 8 8 8 8 2 8 8 8 8 8 8 8 8 8 6 2 7 8 0
0 0 0 0 8 8 8 8 8 8 6 2 2 2 2 2 2 2 2 2 2 2 2 2 2 2 2 2 2 7 8 0
0 0 0 0 8 8 8 8 8 8 6 2 7 8 8 8 8 8 8 8 8 8 8 8 8 8 8 6 2 7 8 0
0 0 0 0 8 8 8 8 8 8 6 2 7 8 8 8 8 8 8 8 8 8 8 8 8 8 8 8 3 3 8 0
0 0 0 0 8 8 8 8 8 8 6 2 7 8 8 8 8 8 8 8 8 8 8 8 8 8 8 6 2 7 8 0
0 0 0 0 8 8 8 8 8 8 6 2 7 8 8 8 8 8 8 8 8 8 8 8 8 8 8 6 2 7 8 0
0 0 0 0 8 8 8 8 8 8 6 3 7 8 8 8 8 8 8 8 8 8 8 2 2 2 2 6 2 7 8 0
0 0 0 0 8 8 8 8 8 8 6 2 7 8 8 8 8 8 8 8 8 8 8 2 2 2 2 6 2 7 8 0
0 0 0 0 8 8 8 8 8 8 6 2 7 8 8 8 8 8 8 8 8 8 8 2 2 2 2 6 2 7 8 0
0 0 0 0 2 2 2 2 2 3 2 2 2 2 2 3 2 2 4 2 2 3 2 2 2 2 2 2 2 2 2 0
0 0 0 0 4 2 3 2 2 2 2 2 2 2 2 2 2 2 2 2 2 2 2 2 3 2 2 2 2 2 2 0
0 0 0 0 2 2 2 3 3 2 2 2 2 2 2 3 2 2 3 2 2 2 3 2 2 2 2 2 4 2 2 0
0 0 0 0 2 2 3 2 2 2 3 2 2 2 2 2 2 3 2 2 2 2 2 2 2 3 2 2 2 2 2 0
0 0 0 0 2 2 3 2 2 2 4 2 3 2 2 2 2 2 2 2 2 4 3 2 2 2 2 2 2 2 4 0
0 0 0 0 2 2 2 2 2 2 3 2 2 2 2 2 3 2 2 2 2 2 2 2 2 2 4 2 2 3 2 0
0 0 0 0 0 0 0 0 0 0 0 0 0 0 0 0 0 0 0 0 0 0 0 0 0 0 0 0 0 0 0 0
0 0 0 0 0 0 0 0 0 0 0 0 0 0 0 0 0 0 0 0 0 0 0 0 0 0 0 0 0 0 0 0